#############################
#A                        ###
# #######################   #
# #   ####                # #
# # # #####          ###### #
# # # #   ################# #
# # # # # #   ############# #
# # # # # # # #           # #
# # # # # # # # ######### # #
# # # # # # #   ######### # #
# # # # #   #####         # #
# # #   #####     ####### # #
# # ##################### # #
#   ###                   # #
####### ##B################ #
########################### #