###########
#   ###B###
# ##### ###
#       ###
# #########
#     #####
### #######
#   #######
#A#########